+--+--+--+--+--+--+
|p |        |     |
+  +  +--+  +  +  +
|  |  |  |     |  |
+  +  +  +--+--+  +
|     |     |     |
+  +--+  +  +  +--+
|  |        |  |  |
+  +  +--+  +  +  +
|     |     |     g|
+--+--+--+--+--+--+
