+--+--+--+--+--+--+--+
|p          |     |  |
+  +--+--+  +  +  +  +
|     |  |     |     |
+  +  +  +  +--+  +  +
|  |     |  |  |     |
+  +  +--+  +  +--+  +
|  |     |     |  |  |
+  +--+  +  +--+  +--+
|     |        |    g|
+--+--+--+--+--+--+--+
